14
9
00000000000000
01111111111110
01100000011110
01122022211110
01112221111110
01111111111110
01111111111110
01111111111110
00000000000000