28
31
0000000000000000000000000000
0111111111111111111111111110
0111111111111111111111111110
0111000000000000000001111110
0111111111102222222222222210
0111111111101111111111111110
0111110000001111111111111110
0111110311101111111111111110
0111110211101111111111111110
0111110211111111111111111110
0111110211111111111111111110
0111110211111111111111111110
0111111111111111111111111110
0111111111111111111111111110
0111111111111110000000000110
0111111111111111111111130110
0111111111111111111111110110
0111111111111111111111110110
0110000000000011111111110110
0110222222222211111111110110
0110211111111111111111111110
0110211111111111111111111110
0110211111111111111111111110
0110211111111111111111111110
0111111111111111111111111110
0111111111111111111111111110
0111111111111111111111111110
0111111111111111111111111110
0111111111111111111111111110
0111111111111111111111111110
0000000000000000000000000000